NO textures/mossy.xpm
SO textures/stars.xpm
WE textures/b_smoke.xpm
EA textures/smoke.xpm
C 0 , 0, 0
F 255 ,255, 255

11111111111111111111111111111111111111
10000000000000000000000000000000000001
10000000000000000000000000000000000001111
111100000000000000000000000000000000000011
    10000000000000000000000000000000000001
1111100000000000000000000000000000000000N11
1000000000000000000000000000000000001111111111
1111111110000000000000000000000000000000000001
        10000000000000000001000000000000000001
        10000000000000000010000000000000000001
        10000000000000000001000000000000000001
        10000000000000000000000000000000000001
        10000000000000000000000000000000000001
        10000000000000000000000000000000001001
        11111111111111111111111111111111111111